111111111111111111111111111111111111111111111111
100000000000000000000000000000000000000000000001
100000000000000000000000000000000000000000000001
10000P000000000000000011111111111000000000000001
100000000000000000000000000000000000000000000001
100000000000001000000000000000000000000000000001
100000000010001000000000000000000000000000000001
100000000010001000000000000000000000000000000001
100000000010001000000000000000000000000000000001
1000000000100010000000000000000CCCCC000000000001
100000000010001000000000000000000000000000000001
10000000001000C000000000000000000000000000000001
100000000010000000000000000000000000000000000001
100000000010000000000000000000000000000000000001
100000000010000000000000C00000000000000000000001
100000000010010000000000000000000000000000000001
100000000010010000000000000000000000000000000001
100000000010010000000000000000000000000000000001
100000000C011100C0000000001101111111000000000001
100000000000000000000000000000000000000000000001
1000000000000000C0000000000000000000000000000001
100000000000000000000000000000000000000000000001
100000000000000000000000000000000000000000000001
100000000000000000000000000000000000000000000001
100000000000000000000000000000000000000000000001
1000000110010000000000000000000000000E0000000001
100000001C00000000000000000000000000000000000001
100000001110000000000000000000000000000000000001
100000000000000000000000000000000000000000000001
100000000000000000000000000000000000000000000001
111111111111111111111111111111111111111111111111