1111111111111
10000000001C1
1000011000001
100001EP00001
1111111111111