1111111111111111111111111111111111
100000000000001C10001C100000000001
1010010100100000101000000000010101
10100100101011E0001001000000010101
1P0000000C00C0100000000000000000C1
1111111111111111111111111111111111