11111111111111111111111111111111111111
10P0000000000CCCC0000000C0CC0000000011
10000000000001111111111111111C00000001
1000000000000CCCC0000000C0CC0000111111
1000000E000000CCCC0000000C0CC000010001
10000000000000CCCC000011110C0C10010001
10000000000000CCCC0001111C0CC000000001
11111111111111111111111111111111111111